32
31
0111111111111111111111111111110
0122222222222201222222222222010
0120000200000201200000200002010
0100111201111201201111201110010
0120111201111201201111201112010
0122222222222222222222222222010
0120000200200000000200200002010
0120111201201111111201201112010
0122222201222201222201222222010
0100000201000001000001200000010
0111111201111001001111201111110
0000001201000000000001201000000
0000001201000000000001201000000
0111111201001100011001201111110
0000000000001000001000000000000
0000000200001000001000200000000
0111111201001111111001201111110
0000001201000000000001201000000
0000001201000000000001201000000
0111111201001111111001201111110
0122222222222201222222222222010
0120000200000201200000200002010
0120111201111201201111201112010
0102201222222220022222201220010
0100201200200000000200201200010
0111201201201111111201201201110
0122222201222201222201222222010
0120000001000201200001000002010
0120111111111201201111111112010
0122222222222222222222222222010
0100000000000000000000000000010
0111111111111111111111111111110