32
31
0111111111111111111111111111110
0122222222222201222222222222010
0122000220000201220000220002010
0120111201111201201111201112010
0120111201111201201111201112010
0122222222222222222222222222010
0122000220220000000220220002010
0120111201201111111201201112010
0122222201222201222201222222010
0100000201000201220001222000010
0111111201111001001111201111110
0000001201000000000001201000000
0000001201000000000001201000000
0111111201001111111001201111110
0222222220001000001000222222220
0000000220001000001000222000000
0111111201001111111001201111110
0000001201000000000001201000000
0000001201000000000001201000000
0111111201001111111001201111110
0122222222222201222222222222010
0120000220000201222000220002010
0120111201111201201111201112010
0122201222222222222222201222010
0100201220222000000222201220010
0111201201201111111201201201110
0122222201222201222201222222010
0122000001000201222001000002010
0120111111111201221111111112010
0122222222222222222222222222010
0100000000000000000000000000010
0111111111111111111111111111110